On Chill	Wale Featuring Jeremih
Ballin'	Mustard Featuring Roddy Ricch
HIGHEST IN THE ROOM	Travis Scott
Baby Sitter	DaBaby Featuring Offset
Hot	Young Thug Featuring Gunna
Suge	DaBaby
Baby	Lil Baby & DaBaby
Enemies	Post Malone Featuring DaBaby
Money In The Grave	Drake Featuring Rick Ross
The London	Young Thug, J. Cole & Travis Scott
Cash Shit	Megan Thee Stallion Featuring DaBaby
YES	Fat Joe, Cardi B & Anuel AA
Panini	Lil Nas X
Hot Girl Summer	Megan Thee Stallion, Nicki Minaj & Ty Dolla $ign
BOP	DaBaby
Woah	Lil Baby
MAMACITA	Tyga X YG X Santana
Follow God	Kanye West
Cut Up	Blac Youngsta
Ran$om	Lil Tecca
BEST ON EARTH	Russ & BIA
All Dat	Moneybagg Yo X Megan Thee Stallon
Writing On The Wall	French Montana Featuring Post Malone, Cardi B & Rvssian
Ride Or Die	Megan Thee Stallion & VickeeLo
Choosy	Fabolous Featuring Jeremih & Davido
Truth Hurts	Lizzo
Goodbyes	Post Malone Featuring Young Thug
Time	NF
My Type	Saweetie
Swervin	A Boogie Wit da Hoodie Featuring 6ix9ine
All Night Long	YFN Lucci Featuring Trey Songz
Wish Wish	DJ Khaled Featuring Cardi B & 21 Savage
Hot Shower	Chance The Rapper Featuring MadeinTYO & DaBaby
Pop Out	Polo G Featuring Lil Tjay
Press	Cardi B
Go Loko	YG, Tyga & Jon Z
Bezerk	Big Sean Featuring A$AP Ferg & Hit-Boy
Single Again	Big Sean
Wiggle It	French Montana Featuring City Girls
Uno	Ambjaay
Going Bad	Meek Mill Featuring Drake
Worth It	YK Osiris
Clout	Offset Featuring Cardi B
Broke Leg	Tory Lanez, Quavo & Tyga
Close Friends	Lil Baby
24/7	Meek Mill Featuring Ella Mai
Old Town Road	Lil Nas X Featuring Billy Ray Cyrus
I Like Girls	PnB Rock Featuring Lil Skies
Pure Water	Mustard & Migos
Act Up	City Girls
Envy Me	Calboy
Bacc At It Again	Yella Beezy, Gucci Mane & Quavo
MEGATRON	Nicki Minaj
Tap	NAV Featuring Meek Mill
Look Back At It	A Boogie Wit da Hoodie
Middle Child	J. Cole
Rule The World	2 Chainz Featuring Ariana Grande
Toast	Koffee
Put A Date On It	Yo Gotti Featuring Lil Baby
A Lot	21 Savage
Please Me	Cardi B & Bruno Mars
Big Ole Freak	Megan Thee Stallion
Light It Up	Marshmello, Tyga & Chris Brown
Slide	French Montana Featuring Blueface & Lil Tjay
2AM	Casanova X 30Roc Featuring Tory Lanez & Davido
Thotiana	Blueface
Drip Too Hard	Lil Baby & Gunna
Wow.	Post Malone
Die Young	Roddy Ricch
21	DaBaby
Poledancer	Wale Featuring Megan Thee Stallion
Twerk	City Girls Featuring Cardi B
Money	Cardi B
Girls Have Fun	Tyga, G-Eazy & Rich The Kid
I Am Who They Say I Am	YoungBoy Never Broke Again Featuring Kevin Gates & Quando Rondo
Sicko Mode	Travis Scott
Be Like Me	Lil Pump Featuring Lil Wayne
ZEZE	Kodak Black Featuring Travis Scott & Offset
Wake Up In The Sky	Gucci Mane X Bruno Mars X Kodak Black
Dangerous	Meek Mill Featuring Jeremih & PnB Rock
Backin' It Up	Pardison Fontaine Featuring Cardi B
Sunflower (Spider-Man: Into The Spider-Verse)	Post Malone & Swae Lee
Mob Ties	Drake
FeRRis WhEEL	Tory Lanez Featuring Trippie Redd
Missin You Crazy	Russ
Leave Me Alone	Flipp Dinero
Uproar	Lil Wayne
Yosemite	Travis Scott
Lil Bebe	DaniLeigh
Say Na	Moneybagg Yo Featuring J. Cole
No Stylist	French Montana Featuring Drake
Major	Young Dolph Featuring Key Glock
Good Form	Nicki Minaj Featuring Lil Wayne
Sauce All On Me	Coca Vango
Mo Bamba	Sheck Wes
Dip	Tyga & Nicki Minaj
Ring	Cardi B Featuring Kehlani
Yes Indeed	Lil Baby & Drake
Smile (Living My Best Life)	Lil' Duval Featuring Snoop Dogg & Ball Greezy
Ice On My Baby	Yung Bleu
Tints	Anderson .Paak And Kendrick Lamar
Uptown Vibes	Meek Mill Featuring Fabolous & Anuel AA
Nonstop	Drake
Taste	Tyga Featuring Offset
Fine China	Future & Juice WRLD
Lucid Dreams	Juice WRLD
W O R K I N  M E	Quavo
Moonlight	XXXTENTACION
Big Bank	YG Featuring 2 Chainz, Big Sean & Nicki Minaj
That's On Me	Yella Beezy
Where The Bag At	City Girls
In My Feelings	Drake
FEFE	6ix9ine Featuring Nicki Minaj & Murda Beatz
Nice For What	Drake
Better Now	Post Malone
Up Now	Saweetie X London On Da Track Featuring G-Eazy & Rich The Kid
I Love It	Kanye West & Lil Pump
I Like It	Cardi B, Bad Bunny & J Balvin
Jealousy	Bri Steves
Chanel (Go Get It)	Young Thug Featuring Gunna & Lil Baby
Apes**t	The Carters
Swervo	G Herbo Featuring Southside
Barbie Dreams	Nicki Minaj
Hopeless Romantic	Wiz Khalifa Featuring Swae Lee
ATM	J. Cole
1942	G-Eazy Featuring Yo Gotti & YBN Nahmir
Narcos	Migos
Sad!	XXXTENTACION
Rover 2.0	BlocBoy JB Featuring 21 Savage
Do Better	Lil Donald
Look Alive	BlocBoy JB Featuring Drake
Plug Walk	Rich The Kid
This Is America	Childish Gambino
Got Friends	GoldLink Featuring Miguel
Be Careful	Cardi B
Win	Jay Rock
Playinwitme	KYLE Featuring Kehlani
God's Plan	Drake
Walk It Talk It	Migos Featuring Drake
Walking Trophy	HoodCelebrityy
Watch	Travis Scott Featuring Lil Uzi Vert & Kanye West
Guatemala	Swae Lee Featuring Slim Jxmmi
Bed	Nicki Minaj Featuring Ariana Grande
Fed Up	Derez De'Shon
KOD	J. Cole
B.I.D	Tory Lanez
Love You Better	King Combs & Chris Brown
Yikes	Kanye West
Psycho	Post Malone Featuring Ty Dolla $ign
Chun-Li	Nicki Minaj
Esskeetit	Lil Pump
Ball For Me	Post Malone Featuring Nicki Minaj
New Freezer	Rich The Kid Featuring Kendrick Lamar
Shoot	BlocBoy JB
Ric Flair Drip	Offset & Metro Boomin
King's Dead	Jay Rock, Kendrick Lamar, Future & James Blake
Love N Hennessy	A.CHAL
Japan	Famous Dex
Love.	Kendrick Lamar Featuring Zacari
Powerglide	Rae Sremmurd & Juicy J
Stir Fry	Migos
Everyday	Logic & Marshmello
All Of A Sudden	Lil Baby Featuring Moneybagg Yo
Proud	2 Chainz Featuring YG & Offset
Icy Grl	Saweetie
Drip	Cardi B Featuring Migos
Crew	GoldLink Featuring Brent Faiyaz & Shy Glizzy
Top Off	DJ Khaled Featuring JAY Z, Future & B
Bartier Cardi	Cardi B Featuring 21 Savage
No Limit	G-Eazy Featuring A$AP Rocky & Cardi B
Nice & Slow	Ball Greezy Featuring Lil Dred
Hardaway	Derez De'Shon
Booty	Blac Youngsta
Icon	Jaden Smith
Plain Jane	A$AP Ferg Featuring Nicki Minaj
Barbie Tingz	Nicki Minaj
Hurtin' Me	Stefflon Don Featuring French Montana
Him & I	G-Eazy & Halsey
Melanin Magic (Pretty Brown)	Remy Ma Featuring Chris Brown
Rockstar	Post Malone Featuring 21 Savage
Let You Down	NF
Lemon	N*E*R*D & Rihanna
So Good	Big Sean & Metro Boomin Featuring Kash Doll
MotorSport	Migos, Nicki Minaj & Cardi B
Pick It Up	Famous Dex Featuring A$AP Rocky
Pills And Automobiles	Chris Brown Featuring Yo Gotti, A Boogie Wit da Hoodie & Kodak Black
I Get The Bag	Gucci Mane Featuring Migos
I Fall Apart	Post Malone
Roll In Peace	Kodak Black Featuring XXXTENTACION
Bodak Yellow (Money Moves)	Cardi B
Unforgettable	French Montana Featuring Swae Lee
Juice	Yo Gotti
Oh I	The Game Featuring Jeremih, Young Thug & Sevyn
Gucci Gang	Lil Pump
My Dawg	Lil Baby
The Way Life Goes	Lil Uzi Vert Featuring Nicki Minaj
Something New	Wiz Khalifa Featuring Ty Dolla $ign
Rake It Up	Yo Gotti Featuring Nicki Minaj
Krippy Kush	Farruko, Nicki Minaj, Bad Bunny, 21 Savage & Rvssian
Butterfly Effect	Travis Scott
Wake Me Up	Remy Ma Featuring Lil' Kim
Pull Up N Wreck	Big Sean & Metro Boomin Featuring 21 Savage
No Limit	G-Eazy Featuring A$AP Rocky & Cardi B
Love.	Kendrick Lamar Featuring Zacari
I Get The Bag	Gucci Mane Featuring Migos
Rockstar	Post Malone Featuring 21 Savage
MotorSport	Migos, Nicki Minaj & Cardi B
Bodak Yellow (Money Moves)	Cardi B
Crew	GoldLink Featuring Brent Faiyaz & Shy Glizzy
Lemon	N*E*R*D & Rihanna
Pills And Automobiles	Chris Brown Featuring Yo Gotti, A Boogie Wit da Hoodie & Kodak Black
Rake It Up	Yo Gotti Featuring Nicki Minaj
Gucci Gang	Lil Pump
Plain Jane	A$AP Ferg Featuring Nicki Minaj
Unforgettable	French Montana Featuring Swae Lee
Humble.	Kendrick Lamar
Loyalty.	Kendrick Lamar Featuring Rihanna
The Way Life Goes	Lil Uzi Vert Featuring Nicki Minaj
Juice	Yo Gotti
Something New	Wiz Khalifa Featuring Ty Dolla $ign
Let You Down	NF
Bank Account	21 Savage
Butterfly Effect	Travis Scott
I Fall Apart	Post Malone
Wake Me Up	Remy Ma Featuring Lil' Kim
Booty	Blac Youngsta
Wokeuplikethis*	Playboi Carti Featuring Lil Uzi Vert
Bam	JAY-Z Featuring Damian "Jr. Gong" Marely
Live Up To My Name	Baka Not Nice
So Excited	Fat Joe Featuring Dre
1-800-273-8255	Logic Featuring Alessia Cara & Khalid
Space	TK Kravitz Featuring Sexton
Too Hotty	Quavo, Takeoff & Offset
Whatever You Need	Meek Mill Featuring Chris Brown & Ty Dolla $ign
DNA.	Kendrick Lamar
What You Like	24 Hrs Featuring Ty Dolla $ign & Wiz Khalifa
It's A Vibe	2 Chainz Featuring Ty Dolla $ign, Trey Songz & Jhene Aiko
I'll Find You	Lecrae Featuring Tori Kelly
Love U Better	Ty Dolla $ign Featuring Lil Wayne & The-Dream
Incredible	Future
XO TOUR Llif3	Lil Uzi Vert
Slippery	Migos Featuring Gucci Mane
Mask Off	Future
Drowning	A Boogie Wit da Hoodie Featuring Kodak Black
Magnolia	Playboi Carti
4:44	JAY-Z
Everyday We Lit	YFN Lucci Featuring PnB Rock
Both	Gucci Mane Featuring Drake
I'm The One	DJ Khaled Featuring Justin Bieber, Quavo, Chance The Rapper & Lil Wayne
Tone It Down	Gucci Mane Featuring Chris Brown
F With U	Kid Ink Featuring Ty Dolla $ign
Water	Joe Gifted Featuring Fronstreet
Fever	Vybz Kartel
No Effort	Tee Grizzley
Congratulations	Post Malone Featuring Quavo
Neighbors	J. Cole
T-Shirt	Migos
Bad And Boujee	Migos Featuring Lil Uzi Vert
Goosebumps	Travis Scott
Tunnel Vision	Kodak Black
Rolex	Ayo & Teo
Pull Up Wit Ah Stick	SahBabii Featuring Loso Loaded
Jump Out The Window	Big Sean
Bounce Back	Big Sean
Portland	Drake Featuring Quavo & Travis Scott
First Day Out	Tee Grizzley
Come Closer	WizKid Featuring Drake
Good Drank	2 Chainz x Gucci Mane x Quavo
Fake Love	Drake
To The Max	DJ Khaled Featuring Drake
Blessings	Lecrae Featuring Ty Dolla $ign
iSpy	KYLE Featuring Lil Yachty
Fashion Week	Wale Featuring G-Eazy
Shining	DJ Khaled Featuring Beyonce & JAY Z
Free Smoke	Drake
Deja Vu	J. Cole
Swang	Rae Sremmurd
Moves	Big Sean
Black Beatles	Rae Sremmurd Featuring Gucci Mane
Skateboard P	MadeinTYO
Money Showers	Fat Joe & Remy Ma Featuring Ty Dolla $ign
Prblms	6LACK
No Frauds	Nicki Minaj, Drake & Lil Wayne
All Night	Chance The Rapper Featuring Knox Fortune
I Think She Like Me	Rick Ross Featuring Ty Dolla $ign
No Problem	Chance The Rapper Featuring Lil Wayne & 2 Chainz
Used To This	Future Featuring Drake
Caroline	Amine
Draco	Future
OTW	DJ Luke Nasty
Bad Things	Machine Gun Kelly x Camila Cabello
Pull Up	Wiz Khalifa Featuring Lil Uzi Vert
Too Much Sauce	DJ ESCO Featuring Future & Lil Uzi Vert
All There	Jeezy Featuring Bankroll Fresh
X	21 Savage & Metro Boomin Featuring Future
Cash Machine	D.R.A.M.
Spend It	Dae Dae
You Was Right	Lil Uzi Vert
Wasted	Dreezy
Girlfriend	Kap G
Now & Later	Sage The Gemini
Broccoli	D.R.A.M. Featuring Lil Yachty
Chill Bill	Rob $tone Featuring J. Davi$ & Spooks
Push It	O.T. Genasis
Childs Play	Drake
For Free	DJ Khaled Featuring Drake
Do You Mind	DJ Khaled Featuring Nicki Minaj, Chris Brown, August Alsina, Jeremih, Future & Rick Ross
OOOUUU	Young M.A
Controlla	Drake
False Prophets	J. Cole
Big Amount	2 Chainz Featuring Drake
Juju On That Beat (TZ Anthem)	Zay Hilfigerrr & Zayion McCall
Pick Up The Phone	Young Thug And Travis Scott Featuring Quavo
Too Good	Drake Featuring Rihanna
All Eyez	The Game Featuring Jeremih
Father Stretch My Hands Pt. 1	Kanye West
What They Want	Russ
Key To The Streets	YFN Lucci Featuring Migos & Trouble
Tiimmy Turner	Desiigner
1 Night	Lil Yachty
Ballerina	Belly
Wat U Mean (Aye, Aye, Aye)	Dae Dae
Panda	Desiigner
Sucker For Pain	Lil Wayne, Wiz Khalifa & Imagine Dragons With Logic & Ty Dolla $ign Feat. X Ambassadors
I Got The Keys	DJ Khaled Featuring Jay Z & Future
My Sh*t	A Boogie Wit da Hoodie
My PYT	Wale
Why You Always Hatin?	YG Featuring Drake & Kamaiyah
Cookin	Fat Joe, Remy Ma & French Montana Featuring RySoValid
Don't Mind	Kent Jones
THat Part	ScHoolboy Q Featuring Kanye West
Really Really	Kevin Gates
Wicked	Future
No Shopping	French Montana Featuring Drake
Devastated	Joey Bada$$
All The Way Up	Fat Joe, Remy Ma & Jay Z Featuring French Montana & Infared
Cut It	O.T. Genasis Featuring Young Dolph
On The Way	TWENTY88
Say Sum	Migos
Low Life	Future Featuring The Weeknd
Drifting	G-Eazy Featuring Chris Brown & Tory Lanez
Dope	T.I. Featuring Marsha Ambrosius
Uber Everywhere	MadeinTYO
Just A Lil' Thick ($he Juicy)	Trinidad James Featuring Mystikal & Lil Dicky
Wake Up	Fetty Wap
Law	Yo Gotti Featuring E-40
Might Not	Belly Featuring The Weeknd
2 Phones	Kevin Gates
Moolah	Young Greatness
No Role Modelz	J. Cole
Jumpman	Drake & Future
Famous	Kanye West
New Level	A$AP Ferg Featuring Future
Promise	Kid Ink Featuring Fetty Wap
Might Be	DJ Luke Nasty
Saved	Ty Dolla $ign Featuring E-40
Ran Off On Da Plug Twice	Plies
Money Talk	T.I.
Me, Myself & I	G-Eazy x Bebe Rexha
Down In The DM	Yo Gotti Featuring Nicki Minaj
Love Yourz	J. Cole
By Chance	Rae Sremmurd
Pop Style	Drake Featuring The Throne
Best Friend	Young Thug
Summer Sixteen	Drake
You Could Be My Lover	Puff Daddy & The Family Featuring Ty Dolla $ign & Gizzle
Do It Like Me	DLOW
Antidote	Travis Scott
Big Rings	Drake & Future
679	Fetty Wap Featuring Remy Boyz
$ave Dat Money	Lil Dicky Featuring Fetty Wap & Rich Homie Quan
Again	Fetty Wap
Moses	French Montana Featuring Chris Brown & Migos
Bottom Of The Bottle	Curren$Y Featuring August Alsina & Lil Wayne
3 Times In A Row	TK N Cash
Hotline Bling	Drake
California	Colonel Loud Featuring T.I., Young Dolph & Ricco Barrino
White Iverson	Post Malone
Milly Rock	2 Milly
Play No Games	Big Sean Featuring Chris Brown & Ty Dolla $ign
WTF (Where They From)	Missy Elliott Featuring Pharrell Williams
Sorry	Rick Ross Featuring Chris Brown
1Hunnid	K Camp Featuring Fetty Wap
Real Friends	Kanye West
Where Ya At	Future Featuring Drake
Back Up	DeJ Loaf Featuring Big Sean
These Walls	Kendrick Lamar Featuring Bilal, Anna Wise & Thundercat
Watch Out	2 Chainz
Like Baby	Jacquees
Blase	Ty Dolla $ign Featuring Future & Rae Sremmurd
Back To Back	Drake
Hit The Quan	iLoveMemphis
All Eyes On You	Meek Mill Featuring Chris Brown & Nicki Minaj
Come Get Her	Rae Sremmurd
My Way	Fetty Wap Featuring Monty
Comfortable	K Camp
Downtown	Macklemore & Ryan Lewis Featuring Eric Nally, Melle Mel, Kool Moe Dee & Grandmaster Caz
Bout 2 Blow	Empire Cast Featuring Yazz & Timbaland
Say It	Tory Lanez
Flex (Ooh Ooh Ooh)	Rich Homie Quan
Nothing But Trouble (Instagram Models)	Lil Wayne & Charlie Puth
We In Da City	Young Dro
Hotline Bling	Drake
679	Fetty Wap Featuring Remy Boyz
My Way	Fetty Wap Featuring Monty
All Eyes On You	Meek Mill Featuring Chris Brown & Nicki Minaj
Flex (Ooh Ooh Ooh)	Rich Homie Quan
Comfortable	K Camp
Where Ya At	Future Featuring Drake
Back To Back	Drake
Blase	Ty Dolla $ign Featuring Future & Rae Sremmurd
Nothing But Trouble (Instagram Models)	Lil Wayne & Charlie Puth
White Iverson	Post Malone
Antidote	Travis Scott
Trap Queen	Fetty Wap
No Role Modelz	J. Cole
Back Up	DeJ Loaf Featuring Big Sean
Downtown	Macklemore & Ryan Lewis Featuring Eric Nally, Melle Mel, Kool Moe Dee & Grandmaster Caz
Again	Fetty Wap
Alright	Kendrick Lamar
We In Da City	Young Dro
Play No Games	Big Sean Featuring Chris Brown & Ty Dolla $ign
This Could Be Us	Rae Sremmurd
Come Get Her	Rae Sremmurd
Twist My Fingaz	YG
Hit The Quan	iLoveMemphis
Finna Get Loose	Puff Daddy & The Family Featuring Pharrell Williams
Watch Me	Silento
Pipe It Up	Migos
Say It	Tory Lanez
Be Real	Kid Ink Featuring DeJ Loaf
How Many Times	DJ Khaled Featuring Chris Brown, Lil Wayne & Big Sean
One Man Can Change The World	Big Sean Featuring Kanye West & John Legend
Poppin	Rico Richie
Nasty Freestyle	T-Wayne
See You Again	Wiz Khalifa Featuring Charlie Puth
Wet Dreamz	J. Cole
The Matrimony	Wale Featuring Usher
Blessings	Big Sean Featuring Drake
Choices (Yup)	E-40
Make Sum Shake	Cool Amerika
Hood Go Crazy	Tech N9Ne Featuring 2 Chainz & B.o.B
Commas	Future
Flicka Da Wrist	Chedda Da Connect
Real Sisters	Future
Truffle Butter	Nicki Minaj Featuring Drake & Lil Wayne
Energy	Drake
I Don't Get Tired (#IDGT)	Kevin Gates Featuring August Alsina
Throw Sum Mo	Rae Sremmurd Featuring Nicki Minaj & Young Thug
Lil Bit	K Camp
Bitches N Marijuana	Chris Brown & Tyga Featuring ScHoolboy Q
Private Show	T.I. Featuring Chris Brown
The Night Is Still Young	Nicki Minaj
All Day	Kanye West Featuring Theophilus London, Allan Kingdom & Paul McCartney
How About Now	Drake
One Time	Migos
Ryda	The Game Featuring DeJ Loaf
G.D.F.R.	Flo Rida Featuring Sage The Gemini & Lookas
King Kunta	Kendrick Lamar
I Don't F**k With You	Big Sean Featuring E-40
Monster	Meek Mill
Tell Em Lies	Rich Gang Featuring Young Thug & Rich Homie Quan
Only	Nicki Minaj Featuring Drake, Lil Wayne & Chris Brown
Feeling Myself	Nicki Minaj Featuring Beyonce
Good Lovin	Ludacris Featuring Miguel
Time Of Our Lives	Pitbull & Ne-Yo
Peaches N Cream	Snoop Dogg Featuring Charlie Wilson
Apparently	J. Cole
Hotel	Kid Ink Featuring Chris Brown
Mind Right	TK N Cash
The Body	Wale Featuring Jeremih
CoCo	O.T. Genasis
Trampoline	Kalin And Myles
Not For Long	B.o.B Featuring Trey Songz
Preach	Young Dolph
Bad B*tch	French Montana Featuring Jeremih
No Type	Rae Sremmurd
Open Wide	Calvin Harris Featuring Big Sean
About The Money	T.I. Featuring Young Thug
Try Me	DeJ Loaf
Backflip	Casey Veggies Featuring YG & iAMSU!
Love Robbery	Kalin And Myles
Lifestyle	Rich Gang Featuring Young Thug & Rich Homie Quan
Body Language	Kid Ink Featuring Usher & Tinashe
Beg For It	Iggy Azalea Featuring M0
Hell Of A Night	ScHoolboy Q
Studio	ScHoolboy Q Featuring BJ The Chicago Kid
Awwsome	Shy Glizzy
Hot Boy	Bobby Shmurda
Made Me	Snootie Wild Featuring K Camp
You And Your Friends	Wiz Khalifa Featuring Snoop Dogg & Ty Dolla $ign
0 To 100 / The Catch Up	Drake
Handsome And Wealthy	Migos
L.A.LOVE (la la)	Fergie
i	Kendrick Lamar
Rich	Kirko Bangz Featuring August Alsina
Right Back	DJ Drama Featuring Jeezy, Young Thug, Rich Homie Quan
Don't Panic	French Montana
Errrbody	Yo Gotti
No Mediocre	T.I. Featuring Iggy Azalea
Black Widow	Iggy Azalea Featuring Rita Ora
Seen It All	Jeezy Featuring Jay Z
No Flex Zone	Rae Sremmurd
Anaconda	Nicki Minaj
Low	Juicy J Featuring Nicki Minaj, Lil Bibby & Young Thug
Believe Me	Lil Wayne Featuring Drake
Fight Night	Migos
Bend Ova	Lil Jon Featuring Tyga
Buy The World	Mike WiLL Made-It Featuring Future, Lil Wayne & Kendrick Lamar
Walk Thru	Rich Homie Quan Featuring Problem
Pills N Potions	Nicki Minaj
Main Chick	Kid Ink Featuring Chris Brown
Or Nah	The Game Featuring Too $hort, Problem, AV & Eric Bellinger
Fancy	Iggy Azalea Featuring Charli XCX
Only That Real	iAMSU! Featuring 2 Chainz & Sage The Gemini
V. 3005	Childish Gambino
Delirious (Boneless)	Steve Aoki, Chris Lake & Tujamo Featuring Kid Ink
We Dem Boyz	Wiz Khalifa
She Twerkin	Ca$h Out
Trophies	Young Money Featuring Drake
Show Me	Kid Ink Featuring Chris Brown
Cut Her Off	KCamp Featuring 2 Chainz
Hookah	Tyga Featuring Young Thug
I Know	Yo Gotti Featuring Rich Homie Quan
Who Do You Love?	YG Featuring Drake
Move That Doh	Future Featuring Pharrell, Pusha T & Casino
I Don't Know	Meek Mill
I Won	Future Featuring Kanye West
They Don't Love You No More	DJ Khaled Featuring Jay Z, Meek Mill, Rick Ross & French Montana
Danny Glover	Young Thug
Part II (On The Run)	Jay Z Featuring Beyonce
College Drop	Sage The Gemini Featuring Kool John
Stoner	Young Thug
Thug Cry	Rick Ross Featuring Lil Wayne
Fragile	Tech N9ne Featuring Kendrick Lamar, MAYDAY! & Kendall Morgan
Show Da World	Lil' Boosie & Webbie Featuring Kiara
Yayo	Snootie Wild & Yo Gotti & DJ Drama
My Hitta	YG Featuring Jeezy & Rich Homie Quan
Money Baby	KCamp Featuring Kwony Ca$h
Smoke	50 Cent Featuring Trey Songz
Headlights	Eminem Featuring Nate Ruess
All Me	Drake Featuring 2 Chainz & Big Sean
Man Of The Year	ScHoolboy Q
The Monster	Eminem Featuring Rihanna
Lookin Ass	Young Money Featuring Nicki Minaj
Feelin' Myself	will.i.am Featuring Miley Cyrus, French Montana, Wiz Khalifa & DJ Mustard
Party Girls	Ludacris Featuring Wiz Khalifa , Jeremih & Cashmere Cat
Holy Grail	Jay Z Featuring Justin Timberlake
Crooked Smile	J. Cole Featuring TLC
Double Cup	DJ Infamous Featuring Jeezy & Ludacris, Juicy J & The Game & Hitmaka
The Language	Drake
The Illest	Far East Movement & Riff Raff
Timber	Pitbull Featuring Ke$ha
Red Nose	Sage The Gemini
OG Bobby Johnson	QUE.
Worst Behavior	Drake
The Devil Is A Lie	Rick Ross Featuring Jay-Z
Tom Ford	JAY-Z
She Knows	J. Cole Featuring Amber Coffman & The Cults
Power Trip	J. Cole Featuring Miguel
Cold Blood	Yo Gotti Featuring J. Cole & Canei Finch
Gas Pedal	Sage The Gemini Featuring IamSu!
23	Mike WiLL Made-It Featuring Miley Cyrus, Wiz Khalifa & Juicy J
Shhh...	Future
F*ckwithmeyouknowigotit	Jay Z Featuring Rick Ross
White Walls	Macklemore & Ryan Lewis Featuring ScHoolboy Q & Hollis
Old School Love	Lupe Fiasco Featuring Ed Sheeran
Ready	B.o.B Featuring Future
Clappers	Wale Featuring Nicki Minaj & Juicy J
Honest	Future
Pound Cake / Paris Morton Music 2	Drake Featuring JAY-Z
I Wanna Be With You	DJ Khaled Featuring Nicki Minaj, Rick Ross & Future
No Games	Rick Ross Featuring Future
Bounce It	Juicy J Featuring Wale & Trey Songz
Beware	Big Sean Featuring Lil Wayne & Jhene Aiko
Collard Greens	ScHoolboy Q Featuring Kendrick Lamar
Used 2	2 Chainz
Memories Back Then	Hustle Gang Featuring T.I., B.o.B, Kendrick Lamar & Kris Stephens
Type Of Way	Rich Homie Quan
HeadBand	B.o.B Featuring 2 Chainz
Feds Watching	2 Chainz Featuring Pharrell
Versace	Migos
Act Right	Yo Gotti Featuring Jeezy & YG
Bad	Wale Featuring Tiara Thomas Or Rihanna
Berzerk	Eminem
Ain't Worried About Nothin	French Montana
Can't Hold Us	Macklemore & Ryan Lewis Featuring Ray Dalton
Same Love	Macklemore & Ryan Lewis Featuring Mary Lambert
U.O.E.N.O.	Rocko Featuring Future & Rick Ross
LoveHate Thing	Wale Featuring Sam Dew
Tapout	Rich Gang Featuring Lil Wayne, Birdman, Future, Mack Maine, Nicki Minaj
Get Like Me	Nelly Featuring Nicki Minaj & Pharrell
Bitch, Don't Kill My Vibe	Kendrick Lamar
No New Friends (SFTB Remix)	DJ Khaled Featuring Drake, Rick Ross & Lil Wayne
Like Whaaat!	Problem Featuring Bad Lucc
Rich As F**k	Lil Wayne Featuring 2 Chainz
Can't Believe It	Flo Rida Featuring Pitbull
Control	Big Sean Featuring Kendrick Lamar & Jay Electronica
We Still In This B****	B.o.B Featuring T.I. & Juicy J
Reason To Hate	DJ Felli Fel Featuring Ne-Yo, Tyga & Wiz Khalifa
Bubble Butt	Major Lazer Featuring Bruno Mars, Tyga & Mystic
High School	Nicki Minaj Featuring Lil Wayne
Power Trip	J. Cole Featuring Miguel
Bad	Wale Featuring Tiara Thomas Or Rihanna
Rich As F**k	Lil Wayne Featuring 2 Chainz
No New Friends (SFTB Remix)	DJ Khaled Featuring Drake, Rick Ross & Lil Wayne
Bitch, Don't Kill My Vibe	Kendrick Lamar
We Still In This B****	B.o.B Featuring T.I. & Juicy J
Can't Hold Us	Macklemore & Ryan Lewis Featuring Ray Dalton
Tapout	Rich Gang Featuring Lil Wayne, Birdman, Future, Mack Maine, Nicki Minaj
Crooked Smile	J. Cole Featuring TLC
U.O.E.N.O.	Rocko Featuring Future & Rick Ross
Love Me	Lil Wayne Featuring Drake & Future
Same Love	Macklemore & Ryan Lewis Featuring Mary Lambert
LoveHate Thing	Wale Featuring Sam Dew
Started From The Bottom	Drake
Ain't Worried About Nothin	French Montana
Feds Watching	2 Chainz Featuring Pharrell
Holy Grail	Jay Z Featuring Justin Timberlake
Bubble Butt	Major Lazer Featuring Bruno Mars, Tyga & Mystic
High School	Nicki Minaj Featuring Lil Wayne
Type Of Way	Rich Homie Quan
HeadBand	B.o.B Featuring 2 Chainz
Reason To Hate	DJ Felli Fel Featuring Ne-Yo, Tyga & Wiz Khalifa
Like Whaaat!	Problem Featuring Bad Lucc
Versace	Migos
Act Right	Yo Gotti Featuring Jeezy & YG
Ready	Fabolous Featuring Chris Brown
FDB	Young Dro
Poetic Justice	Kendrick Lamar Featuring Drake
Karate Chop (Remix)	Future Featuring Lil Wayne
Crickets	Drop City Yacht Club Featuring Jeremih
F**kin Problems	A$AP Rocky Featuring Drake, 2 Chainz & Kendrick Lamar
Wild For The Night	A$AP Rocky Featuring Skrillex
Freaks	French Montana Featuring Nicki Minaj
Show Out	Juicy J Featuring Big Sean & Young Jeezy
Bugatti	Ace Hood Featuring Future & Rick Ross
Feel This Moment	Pitbull Featuring Christina Aguilera
R.I.P.	Young Jeezy Featuring 2 Chainz
Thrift Shop	Macklemore & Ryan Lewis Featuring Wanz
So Many Girls	DJ Drama Featuring Wale, Tyga & Roscoe Dash
Battle Scars	Lupe Fiasco & Guy Sebastian
Swimming Pools (Drank)	Kendrick Lamar
Open Letter	JAY-Z
All Gold Everything	Trinidad James
Female$ Welcomed	Trinidad James
Neva End	Future
Believe It	Meek Mill Featuring Rick Ross
Dope	Tyga Featuring Rick Ross
Hello	T.I. Featuring Cee Lo Green
All That (Lady)	The Game Featuring Lil Wayne, Big Sean, Fabolous & Jeremih
I'm Different	2 Chainz
Keep It Trill	Kirko Bangz
Remember You	Wiz Khalifa Featuring The Weeknd
Ball	T.I. Featuring Lil Wayne
Clique	Kanye West, Jay-Z, Big Sean
Don't Stop The Party	Pitbull Featuring TJR
No Worries	Lil Wayne Featuring Detail
Pop That	French Montana Featuring Rick Ross, Drake, Lil Wayne
She Don't Put It Down	Joe Budden Featuring Lil Wayne & Tank
Guap	Big Sean
Bandz A Make Her Dance	Juicy J Featuring Lil Wayne & 2 Chainz
I Cry	Flo Rida
Celebration	Game Featuring Chris Brown, Tyga, Wiz Khalifa & Lil Wayne
Love Sosa	Chief Keef
Representin'	Ludacris Featuring Kelly Rowland
Diced Pineapples	Rick Ross Featuring Wale & Drake
Young & Gettin' It	Meek Mill Featuring Kirko Bangz
My Moment	DJ Drama Featuring 2 Chainz, Meek Mill & Jeremih
Birthday Song	2 Chainz Featuring Kanye West
No Lie	2 Chainz Featuring Drake
Turn On The Lights	Future
Hold Up	Ca$h Out Featuring Wale
Mercy	Kanye West, Big Sean, Pusha T, 2 Chainz
Slow Down	Clyde Carson Featuring The Team
Whistle	Flo Rida
Nobody's Perfect	J. Cole Featuring Missy Elliott
Cashin' Out	Ca$h Out
Amen	Meek Mill Featuring Drake
Gangnam Style	PSY
I Don't Like	Chief Keef Featuring Lil Reese
Work Hard, Play Hard	Wiz Khalifa
Do It	Mykko Montana Featuring K-Camp
Bag Of Money	Wale Featuring Rick Ross, Meek Mill & T-Pain
Go Get It	T.I.
Take It To The Head	DJ Khaled Featuring Chris Brown, Rick Ross, Nicki Minaj & Lil Wayne
I Wish You Would	DJ Khaled Featuring Kanye West & Rick Ross
Leave You Alone	Young Jeezy Featuring Ne-Yo
New Day	50 Cent Featuring Dr. Dre & Alicia Keys
Touch'N You	Rick Ross Featuring Usher
Snap Backs & Tattoos	Driicky Graham
Drank In My Cup	Kirko Bangz
Beez In The Trap	Nicki Minaj Featuring 2 Chainz
The Motto	Drake Featuring Lil Wayne
My Homies Still	Lil Wayne Featuring Big Sean
Till I Die	Chris Brown Featuring Big Sean & Wiz Khalifa
Get Low	Waka Flocka Flame Featuring Nicki Minaj, Tyga & Flo Rida
Make It Nasty	Tyga
Born Stunna	Birdman Featuring Rick Ross
HYFR (Hell Ya F*****g Right)	Drake Featuring Lil Wayne
Wild Ones	Flo Rida Featuring Sia
Faded	Tyga Featuring Lil Wayne
Take Care	Drake Featuring Rihanna
Crew Love	Drake Featuring The Weeknd
Starships	Nicki Minaj
UP!	LoveRance Featuring IamSu & Skipper or 50 Cent
Same Damn Time	Future
The Recipe	Kendrick Lamar Featuring Dr. Dre
Ayy Ladies	Travis Porter Featuring Tyga
I Dont Really Care	Waka Flocka Flame Featuring Trey Songz
Back In Time	Pitbull
Another Round	Fat Joe Featuring Chris Brown
Function	E-40 With YG, iAMSU! & Problem
Stay Schemin	Rick Ross Featuring Drake & French Montana
Magic	Future Featuring T.I.
So Good	B.o.B
Can't Get Enough	J. Cole Featuring Trey Songz
Rack City	Tyga
Sabotage	Wale Featuring Lloyd
Young, Wild & Free	Snoop Dogg & Wiz Khalifa Featuring Bruno Mars
Ni**as in Paris	Jay Z Kanye West
Lotus Flower Bomb	Wale Featuring Miguel
Make Me Proud	Drake Featuring Nicki Minaj
I Do	Young Jeezy Featuring Jay-Z & Andre 3000
Do It Like You	Diggy Featuring Jeremih
International Love	Pitbull Featuring Chris Brown
No Church In The Wild	Jay Z Kanye West Featuring Frank Ocean
SupaFreak	Young Jeezy Featuring 2 Chainz
Dance (A$$)	Big Sean Featuring Nicki Minaj
Work Out	J. Cole
Good Feeling	Flo Rida
Gotta Have It	Jay Z Kanye West
Round Of Applause	Waka Flocka Flame Featuring Drake
You The Boss	Rick Ross Featuring Nicki Minaj
Shot Caller	French Montana Featuring Charlie Rock
Sexy And I Know It	LMFAO
Headlines	Drake
Strange Clouds	B.o.B Featuring Lil Wayne
House Party	Meek Mill Featuring Young Chris
She Will	Lil Wayne Featuring Drake
Glory	Jay-Z Featuring B.I.C.
Mirror	Lil Wayne Featuring Bruno Mars
That Way	Wale Featuring Jeremih & Rick Ross
Fly	Nicki Minaj Featuring Rihanna
Fly Together	Red Cafe Featuring Ryan Leslie & Rick Ross
Body 2 Body	Ace Hood Featuring Chris Brown
Good Good Night	Roscoe Dash
Marvin & Chardonnay	Big Sean Featuring Kanye West & Roscoe Dash
I'm On One	DJ Khaled Featuring Drake, Rick Ross & Lil Wayne
Ima Boss	Meek Mill Featuring T.I., Birdman, Lil Wayne, DJ Khaled, Rick Ross & Swizz Beatz
Otis	Jay Z Kanye West Featuring Otis Redding
Tony Montana	Future
Lighters	Bad Meets Evil Featuring Bruno Mars
Party Rock Anthem	LMFAO Featuring Lauren Bennett & GoonRock
Give Me Everything	Pitbull Featuring Ne-Yo, Afrojack & Nayer
Super Bass	Nicki Minaj
Better With The Lights Off	New Boyz Featuring Chris Brown
I'm Flexin'	T.I. Featuring Big K.R.I.T.
Far Away	Tyga Featuring Chris Richardson
My Last	Big Sean Featuring Chris Brown
Out Of My Head	Lupe Fiasco Featuring Trey Songz
Copy, Paste	Diggy
Got 2 Luv U	Sean Paul Featuring Alexis Jordan
Gucci Gucci	Kreayshawn
Y.U. Mad	Birdman Featuring Nicki Minaj & Lil Wayne
No Sleep	Wiz Khalifa
Oh My	DJ Drama Featuring Fabolous, Roscoe Dash & Wiz Khalifa
On My Level	Wiz Khalifa Featuring Too $hort
Look At Me Now	Chris Brown Featuring Lil Wayne & Busta Rhymes
No Hands	Waka Flocka Flame Featuring Roscoe Dash & Wale
The Show Goes On	Lupe Fiasco
All Of The Lights	Kanye West
John	Lil Wayne Featuring Rick Ross
Till I'm Gone	Tinie Tempah Featuring Wiz Khalifa
Roll Up	Wiz Khalifa
Ballin'	Young Jeezy Featuring Lil Wayne
Rain Over Me	Pitbull Featuring Marc Anthony
How To Love	Lil Wayne
Racks	YC Featuring Future
Hustle Hard	Ace Hood
We Can Get It On	Yo Gotti
Moment 4 Life	Nicki Minaj Featuring Drake
9 Piece	Rick Ross Featuring Lil Wayne Or T.I.
Country Sh*t	Big K.R.I.T.
Bring It Back	Travis Porter
Tupac Back	Meek Mill Featuring Rick Ross
Did It On'em	Nicki Minaj
Grove St. Party	Waka Flocka Flame Featuring Kebo Gotti
Where Them Girls At	David Guetta Featuring Flo Rida & Nicki Minaj
Backseat	New Boyz Featuring The Cataracs & Dev
You Be Killin Em	Fabolous
Booty Wurk (One Cheek At A Time)	T-Pain Featuring Joey Galaxy
6 Foot 7 Foot	Lil Wayne Featuring Cory Gunz
Your Love	Diddy - Dirty Money Featuring Trey Songz
Written In The Stars	Tinie Tempah Featuring Eric Turner
I Don't Deserve You	Lloyd Banks Featuring Jeremih
I Need A Doctor	Dr. Dre Featuring Eminem & Skylar Grey
Up All Night	Drake Featuring Nicki Minaj
Start It Up	Lloyd Banks Featuring Kanye West, Swizz Beatz, Fabolous & Ryan Leslie
Coming Home	Diddy - Dirty Money Featuring Skylar Grey
Welcome To My Hood	DJ Khaled Featuring Rick Ross, Plies, Lil Wayne & T-Pain
Aston Martin Music	Rick Ross Featuring Drake & Chrisette Michele
Black And Yellow	Wiz Khalifa
Moment 4 Life	Nicki Minaj Featuring Drake
Look At Me Now	Chris Brown Featuring Lil Wayne & Busta Rhymes
All Of The Lights	Kanye West
6 Foot 7 Foot	Lil Wayne Featuring Cory Gunz
Did It On'em	Nicki Minaj
Roll Up	Wiz Khalifa
No Hands	Waka Flocka Flame Featuring Roscoe Dash & Wale
You Be Killin Em	Fabolous
The Show Goes On	Lupe Fiasco
Grove St. Party	Waka Flocka Flame Featuring Kebo Gotti
Racks	YC Featuring Future
Aston Martin Music	Rick Ross Featuring Drake & Chrisette Michele
Backseat	New Boyz Featuring The Cataracs & Dev
Bring It Back	Travis Porter
Black And Yellow	Wiz Khalifa
Hey Baby (Drop It To The Floor)	Pitbull Featuring T-Pain
Hustle Hard	Ace Hood
I Need A Doctor	Dr. Dre Featuring Eminem & Skylar Grey
Rocketeer	Far*East Movement Featuring Ryan Tedder
Make A Movie	Twista Featuring Chris Brown
My Last	Big Sean Featuring Chris Brown
Welcome To My Hood	DJ Khaled Featuring Rick Ross, Plies, Lil Wayne & T-Pain
I Don't Deserve You	Lloyd Banks Featuring Jeremih
Kush	Dr. Dre Featuring Snoop Dogg & Akon
Coming Home	Diddy - Dirty Money Featuring Skylar Grey
Right Above It	Lil Wayne Featuring Drake
H*A*M	Kanye West Jay Z
Buzzin'	Mann
Make It Rain	Travis Porter
Sweat	Snoop Dogg
Fancy	Drake Featuring T.I. & Swizz Beatz
Like A G6	Far*East Movement Featuring Cataracs & Dev
Fire Flame	Birdman Featuring Lil Wayne
Right Thru Me	Nicki Minaj
Up All Night	Drake Featuring Nicki Minaj
Ain't Thinkin' 'Bout You	Bow Wow Featuring Chris Brown
Go Girl	Baby Bash Featuring E-40
Just A Dream	Nelly
So High	Slim Thug Featuring B.o.B
Monster	Kanye West Featuring Jay-Z, Rick Ross, Bon Iver & Nicki Minaj
Get Back Up	T.I. Featuring Chris Brown
No Love	Eminem Featuring Lil Wayne
Runaway	Kanye West Featuring Pusha T
Beat It Up	Gucci Mane Featuring Trey Songz
Aston Martin Music	Rick Ross Featuring Drake & Chrisette Michele
No Hands	Waka Flocka Flame Featuring Roscoe Dash & Wale
Right Thru Me	Nicki Minaj
Right Above It	Lil Wayne Featuring Drake
Black And Yellow	Wiz Khalifa
Like A G6	Far*East Movement Featuring Cataracs & Dev
Just A Dream	Nelly
Make A Movie	Twista Featuring Chris Brown
Fancy	Drake Featuring T.I. & Swizz Beatz
Hey Baby (Drop It To The Floor)	Pitbull Featuring T-Pain
Kush	Dr. Dre Featuring Snoop Dogg & Akon
Runaway	Kanye West Featuring Pusha T
You Be Killin Em	Fabolous
No Love	Eminem Featuring Lil Wayne
Fire Flame	Birdman Featuring Lil Wayne
Make It Rain	Travis Porter
Moment 4 Life	Nicki Minaj Featuring Drake
Monster	Kanye West Featuring Jay-Z, Rick Ross, Bon Iver & Nicki Minaj
Love The Way You Lie	Eminem Featuring Rihanna
Get Back Up	T.I. Featuring Chris Brown
So High	Slim Thug Featuring B.o.B
Rocketeer	Far*East Movement Featuring Ryan Tedder
Beat It Up	Gucci Mane Featuring Trey Songz
Start It Up	Lloyd Banks Featuring Kanye West, Swizz Beatz, Fabolous & Ryan Leslie
Buzzin'	Mann
Miss Me	Drake Featuring Lil Wayne
Making Love To The Money	Gucci Mane
Speakers Going Hammer	Soulja Boy
Club Can't Handle Me	Flo Rida Featuring David Guetta
Toot It And Boot It	YG
B.M.F. (Blowin' Money Fast)	Rick Ross Featuring Styles P
Bitch	E-40 Featuring Too $hort
Bad (That's Her)	Lil Scrappy Featuring Stuey Rock
Loving You No More	Diddy - Dirty Money Featuring Drake
Roman's Revenge	Nicki Minaj Featuring Eminem
Your Love	Nicki Minaj
Get Big	Dorrough
Got Your Back	T.I. Featuring Keri Hilson
Check It Out	will.i.am & Nicki Minaj
Airplanes	B.o.B Featuring Hayley Williams
Gucci Time	Gucci Mane Featuring Swizz Beatz
Teach Me How To Dougie	Cali Swag District
Where You Are	Cali Swag District
Pretty Boy Swag	Soulja Boy Tell'em
Love The Way You Lie	Eminem Featuring Rihanna
Fancy	Drake Featuring T.I. & Swizz Beatz
Miss Me	Drake Featuring Lil Wayne
Right Above It	Lil Wayne Featuring Drake
Like A G6	Far*East Movement Featuring Cataracs & Dev
B.M.F. (Blowin' Money Fast)	Rick Ross Featuring Styles P
Got Your Back	T.I. Featuring Keri Hilson
Your Love	Nicki Minaj
Just A Dream	Nelly
No Hands	Waka Flocka Flame Featuring Roscoe Dash & Wale
Toot It And Boot It	YG
Gucci Time	Gucci Mane Featuring Swizz Beatz
Club Can't Handle Me	Flo Rida Featuring David Guetta
Aston Martin Music	Rick Ross Featuring Drake & Chrisette Michele
Monster	Kanye West Featuring Jay-Z, Rick Ross, Bon Iver & Nicki Minaj
Airplanes	B.o.B Featuring Hayley Williams
Teach Me How To Dougie	Cali Swag District
Loving You No More	Diddy - Dirty Money Featuring Drake
Check It Out	will.i.am & Nicki Minaj
Right Thru Me	Nicki Minaj
Get Big	Dorrough
Pretty Boy Swag	Soulja Boy Tell'em
Where You Are	Cali Swag District
Break My Bank	New Boyz Featuring Iyaz
I'm Single	Lil Wayne
Loyalty	Birdman Featuring Tyga & Lil Wayne
Not Afraid	Eminem
Billionaire	Travie McCoy Featuring Bruno Mars
143	Bobby Brackins Featuring Ray J
Any Girl	Lloyd Banks Featuring Lloyd
Lose My Mind	Young Jeezy Featuring Plies
Nothin' On You	B.o.B Featuring Bruno Mars
POWER	Kanye West
Up All Night	Drake Featuring Nicki Minaj
Sex Room	Ludacris Featuring Trey Songz
Hard In Da Paint	Waka Flocka Flame
Over	Drake
Hello Good Morning	Diddy - Dirty Money Featuring T.I.
Who Dat	J. Cole
All I Do Is Win	DJ Khaled Featuring T-Pain, Ludacris, Snoop Dogg & Rick Ross
Magic	B.o.B Featuring Rivers Cuomo
Your Love	Nicki Minaj
Love The Way You Lie	Eminem Featuring Rihanna
Airplanes	B.o.B Featuring Hayley Williams
Lose My Mind	Young Jeezy Featuring Plies
Pretty Boy Swag	Soulja Boy Tell'em
Miss Me	Drake Featuring Lil Wayne
Teach Me How To Dougie	Cali Swag District
Over	Drake
Billionaire	Travie McCoy Featuring Bruno Mars
Hello Good Morning	Diddy - Dirty Money Featuring T.I.
Sex Room	Ludacris Featuring Trey Songz
B.M.F. (Blowin' Money Fast)	Rick Ross Featuring Styles P
Got Your Back	T.I. Featuring Keri Hilson
Nothin' On You	B.o.B Featuring Bruno Mars
Not Afraid	Eminem
POWER	Kanye West
All I Do Is Win	DJ Khaled Featuring T-Pain, Ludacris, Snoop Dogg & Rick Ross
My Chick Bad	Ludacris Featuring Nicki Minaj
Who Dat	J. Cole
Break My Bank	New Boyz Featuring Iyaz
Hard In Da Paint	Waka Flocka Flame
143	Bobby Brackins Featuring Ray J
I'm Back	T.I.
Fancy	Drake Featuring T.I. & Swizz Beatz
Toot It And Boot It	YG
Super High	Rick Ross Featuring Ne-Yo
If It Ain't About Money	Fat Joe Featuring Trey Songz
Beamer, Benz, Or Bentley	Lloyd Banks Featuring Juelz Santana
I'm Single	Lil Wayne
Say Something	Timbaland Featuring Drake
BedRock	Young Money Featuring Lloyd
She Got It Made	Plies
Young Forever	Jay-Z + Mr. Hudson
Roger That	Young Money
Steady Mobbin'	Young Money Featuring Gucci Mane
Show Out	Roscoe Dash
Fantasy Girl	Baby Bash Featuring Marty James
Alright	Pitbull Featuring Machel Montano
Back To The Crib	Juelz Santana Featuring Chris Brown
How Low	Ludacris
Bring It Back	8Ball & MJG Featuring Young Dro
Tie Me Down	New Boyz Featuring Ray J
Lemonade	Gucci Mane
O Let's Do It	Waka Flocka Flame
Empire State Of Mind	Jay-Z + Alicia Keys
On To The Next One	Jay-Z + Swizz Beatz
4 My Town (Play Ball)	Birdman Featuring Drake & Lil Wayne
Women Lie, Men Lie	Yo Gotti Featuring Lil Wayne
(HaHa) Slow Down	Fat Joe Featuring Jeezy
All The Way Turnt Up	Roscoe Dash Featuring Soulja Boy Tell'em
Go Shorty Go	Travis Porter
I Wanna Rock	Snoop Dogg
Flex	The Party Boyz
Forever	Drake Featuring Kanye West, Lil Wayne & Eminem
Armada Latina	Cypress Hill Featuring Pittbull & Marc Anthony
Money To Blow	Birdman Featuring Lil Wayne & Drake
Do You Think About Me	50 Cent
Million Dollar Girl	Trina Featuring Diddy & Keri Hilson
Gangsta Luv	Snoop Dogg Featuring The-Dream
Shut It Down	Pitbull Featuring Akon
Spotlight	Gucci Mane Featuring Usher
Run This Town	Jay-Z, Rihanna & Kanye West
Homegurl (He Gotta)	Bone
Medicine	Plies Featuring Keri Hilson
Fed Up	DJ Khaled Featuring Usher, Drake, Young Jeezy & Rick Ross
Baby By Me	50 Cent Featuring Ne-Yo
I Get Crazy	Nicki Minaj Featuring Lil Wayne
Wasted	Gucci Mane Featuring Plies Or OJ Da Juiceman
Best I Ever Had	Drake
Throw It In The Bag	Fabolous Featuring The-Dream
On Fire	Lil Wayne
I Look Good	Chalie Boy
Fresh	6 Tre G
I'm Going In	Drake Featuring Lil Wayne & Young Jeezy
Everything, Everyday, Everywhere	Fabolous Featuring Keri Hilson
Successful	Drake Featuring Trey Songz & Lil Wayne
5 Star	Yo Gotti
Gotta Get It	Juvenile
Be On You	Flo Rida Featuring Ne-Yo
Hotel Room Service	Pitbull
I'm Good	Clipse Featuring Pharrell
Ice Cream Paint Job	Dorrough
Every Girl	Young Money
Better Believe It	Lil Boosie Featuring Young Jeezy & Webbie
Becky	Plies
Wetter (Calling You Daddy)	Twista Featuring Erika Shevon
Trick'n	Mullage
La La La	LMFAO
Shots	LMFAO Featuring Lil Jon
Written On Her	Birdman Featuring Jay Sean
Outta Control	Baby Bash Featuring Pitbull
Shake My	Three 6 Mafia Featuring Kalenna
You're A Jerk	New Boyz
Boom Boom Pow	The Black Eyed Peas
I Know You Want Me (Calle Ocho)	Pitbull
Make Her Say	Kid Cudi Featuring Kanye West & Common
Always Strapped	Birdman Featuring Lil Wayne
The Warning	Eminem
So Fine	Sean Paul
Million Bucks	Maino Featuring Swizz Beatz
Plenty Money	Plies
Best I Ever Had	Drake
Every Girl	Young Money
Wetter (Calling You Daddy)	Twista Featuring Erika Shevon
Successful	Drake Featuring Trey Songz & Lil Wayne
Throw It In The Bag	Fabolous Featuring The-Dream
You're A Jerk	New Boyz
Ice Cream Paint Job	Dorrough
Run This Town	Jay-Z, Rihanna & Kanye West
Hotel Room Service	Pitbull
Always Strapped	Birdman Featuring Lil Wayne
Be On You	Flo Rida Featuring Ne-Yo
Make Her Say	Kid Cudi Featuring Kanye West & Common
So Fine	Sean Paul
Boom Boom Pow	The Black Eyed Peas
I Know You Want Me (Calle Ocho)	Pitbull
Wasted	Gucci Mane Featuring Plies Or OJ Da Juiceman
5 Star	Yo Gotti
D.O.A. (Death Of Auto-Tune)	JAY-Z
Dead And Gone	T.I. Featuring Justin Timberlake
Becky	Plies
Trick'n	Mullage
Download	Lil Kim Featuring T-Pain & Charlie Wilson
Million Bucks	Maino Featuring Swizz Beatz
Who's Real	Jadakiss Featuring Swizz Beatz & OJ Da Juiceman
Plenty Money	Plies
Swag Surfin'	F.L.Y. (Fast Life Yungstaz)
Kiss Me Thru The Phone	Soulja Boy Tell 'em Featuring Sammie
Dancin On Me	Webstar & Jim Jones Featuring Juelz Santana
All The Above	Maino Featuring T-Pain
Turn My Swag On	Soulja Boy Tell'em
Sugar	Flo Rida Featuring Wynter
Halle Berry (She's Fine)	Hurricane Chris Featuring SupaSTAAR
Echo	Gorilla Zoe
Ain't I	Yung L.A. Featuring Young Dro & T.I.
Right Round	Flo Rida
Magnificent	Rick Ross Featuring John Legend
Heartless	Kanye West
Walk That Walk	Dorrough
Make Tha Trap Say Aye	OJ Da Juiceman Featuring Gucci Mane
Whatever You Like	T.I.
You Can Get It All	Bow Wow Featuring Johnta Austin
We Made You	Eminem
Next To You	Mike Jones
Stanky Legg	GS Boyz
Live Your Life	T.I. Featuring Rihanna
I'm The Ish	DJ Class Featuring Lil Jon
Bizzy Body	Paul Wall Featuring Webbie & Mouse
Move (If You 'W'anna)	Mims
Hustler's Anthem '09	Busta Rhymes Featuring T-Pain
Want It, Need It	Plies Featuring Ashanti
I Love College	Asher Roth
Crack A Bottle	Eminem, Dr. Dre & 50 Cent
Pop Champagne	Jim Jones & Ron Browz Featuring Juelz Santana
Amazing	Kanye West Featuring Young Jeezy
Feel It	DJ Felli Fel Featuring T-Pain, Sean Paul, Flo Rida & Pitbull
I Run	Slim Thug
That's How I Go	Baby Bash Featuring Lil Jon & Mario
Lost	Gorilla Zoe
I Get It In	50 Cent
One More Drink	Ludacris Co-Starring T-Pain
Mrs. Officer	Lil Wayne Featuring Bobby Valentino & Kidd Kidd
Put It On Ya	Plies Featuring Chris J
Nasty Girl	Ludacris Co-Staring Plies
Jumping (Out The Window)	Ron Browz
My President	Young Jeezy Featuring Nas
Universal Mind Control	Common Featuring Pharrell
Brooklyn Go Hard	Jay-Z Featuring Santogold
Arab Money	Busta Rhymes Featuring Ron Browz
Got Money	Lil Wayne Featuring T-Pain
Swagga Like Us	Jay-Z & T.I. Featuring Kanye West & Lil Wayne
Get Like Me	David Banner Featuring Chris Brown
My Life	The Game Featuring Lil Wayne
Paper Planes	M.I.A.
Bust It Wide Open	Lil Wil
Go Hard	DJ Khaled Featuring Kanye West & T-Pain
Bird Walk	Soulja Boy Tell'em
Get Up	50 Cent
Ride	Ace Hood Featuring Trey Songz
Put On	Young Jeezy Featuring Kanye West
By My Side	Jadakiss Featuring Ne-Yo
Dangerous	Kardinal Offishall Featuring Akon
Krazy	Pitbull Featuring Lil Jon
What Them Girls Like	Ludacris Co-Starring Chris Brown & Sean Garrett
Show Out	Unk
Mr. Carter	Lil Wayne Featuring Jay-Z
Please Excuse My Hands	Plies Featuring Jamie Foxx & The-Dream
Cuddy Buddy	Mike Jones Featuring Trey Songz & Twista
Swing	Savage Featuring Soulja Boy Tell'em
Body On Me	Nelly Featuring Ashanti & Akon
The Business	Yung Berg Featuring Casha
A Milli	Lil Wayne
Here I Am	Rick Ross Featuring Nelly & Avery Storm
Baby	LL Cool J Featuring The-Dream
Marco Polo	Bow Wow Featuring Soulja Boy Tell'em
Shawty Say	David Banner Featuring Lil Wayne
Bust It Baby Part 2	Plies Featuring Ne-Yo
Jockin' JAY-Z	JAY-Z
Lollipop	Lil Wayne Featuring Static Major
Lolli Lolli (Pop That Body)	Three 6 Mafia Featuring Project Pat, Young D & Superpower
Out Here Grindin	DJ Khaled Feat. Akon, Plies, Young Jeezy, Rick Ross, Ace Hood, Trick Daddy & Lil' Boosie
Put On	Young Jeezy Featuring Kanye West
Get Like Me	David Banner Featuring Chris Brown
Got Money	Lil Wayne Featuring T-Pain
A Milli	Lil Wayne
Whatever You Like	T.I.
The Business	Yung Berg Featuring Casha
Here I Am	Rick Ross Featuring Nelly & Avery Storm
Dangerous	Kardinal Offishall Featuring Akon
Mrs. Officer	Lil Wayne Featuring Bobby Valentino & Kidd Kidd
Bust It Baby Part 2	Plies Featuring Ne-Yo
Baby	LL Cool J Featuring The-Dream
Please Excuse My Hands	Plies Featuring Jamie Foxx & The-Dream
My Life	The Game Featuring Lil Wayne
Body On Me	Nelly Featuring Ashanti & Akon
Lollipop	Lil Wayne Featuring Static Major
Lolli Lolli (Pop That Body)	Three 6 Mafia Featuring Project Pat, Young D & Superpower
Cuddy Buddy	Mike Jones Featuring Trey Songz & Twista
Mr. Carter	Lil Wayne Featuring Jay-Z
What Them Girls Like	Ludacris Co-Starring Chris Brown & Sean Garrett
In The Ayer	Flo Rida Featuring will.i.am
Out Here Grindin	DJ Khaled Feat. Akon, Plies, Young Jeezy, Rick Ross, Ace Hood, Trick Daddy & Lil' Boosie
Jockin' JAY-Z	JAY-Z
Paper Planes	M.I.A.
Game's Pain	The Game Featuring Keyshia Cole
Swagga Like Us	Jay-Z & T.I. Featuring Kanye West & Lil Wayne
Lookin Boy	Hot Stylz Featuring Yung Joc
Swing	Savage Featuring Soulja Boy Tell'em
Donk	Soulja Boy Tell'em
Hi Hater	Maino
Get Silly	V.I.C.
The Boss	Rick Ross Featuring T-Pain
So Fly	Slim Featuring Yung Joc
Foolish	Shawty Lo
Low	Flo Rida Featuring T-Pain
She Got It	2 Pistols Featuring T-Pain & Tay Dizm
Homecoming	Kanye West Featuring Chris Martin
Independent	Webbie Featuring Lil' Phat & Lil' Boosie
Finer Things	DJ Felli Fel Featuring Kanye West, Jermaine Dupri, Fabolous & Ne-Yo
Don't Stop	Baby Bash Featuring Keith Sweat
No Matter What	T.I.
Life Of Da Party	Snoop Dogg Featuring Too $hort & Mistah F.A.B.
I Know	Jay-Z Featuring Pharrell
That's Gangsta	Bun-B Featuring Sean Kingston
I Like The Way She Do It	G Unit
Go Girl	Pitbull Featuring Trina & Young Bo$$
Dey Know	Shawty Lo
Party People	Nelly Featuring Fergie
Umma Do Me	Rocko
Say Yeah	Wiz Khalifa
Elevator	Flo Rida Featuring Timbaland
Drop & Gimme 50	Mike Jones Featuring Hurricane Chris
Superstar	Lupe Fiasco Featuring Matthew Santos
I Won't Tell	Fat Joe Featuring J. Holiday
Boyfriend/Girlfriend	C-Side Featuring Keyshia Cole
My Dougie	Lil Wil
Ching-A-Ling	Missy Elliott
Shawty Get Loose	Lil Mama Featuring Chris Brown & T-Pain
The Anthem	Pitbull Featuring Lil Jon
Flashing Lights	Kanye West Featuring Dwele
Good Life	Kanye West Featuring T-Pain
YAHHH!	Soulja Boy Tell'em Featuring Arab
Good Love	Sheek Louch
Hypnotized	Plies Featuring Akon
Who The F*** Is That?	Dolla Featuring T-Pain & Tay Dizm
Pop Bottles	Birdman Featuring Lil Wayne
Give You The World	The D.E.Y.
You're Welcome	Jay-Z Featuring Mary J. Blige
Single Again	Trina
Crank That (Soulja Boy)	Soulja Boy Tell'em
What Is It	Baby Bash Featuring Sean Kingston
Hey Baby (Jump Off)	Bow Wow & Omarion
Duffle Bag Boy	Playaz Circle Featuring Lil Wayne
I'm So Hood	DJ Khaled Featuring T-Pain, Trick Daddy, Rick Ross & Plies
Cyclone	Baby Bash Featuring T-Pain
Certified	Glasses Malone Featuring Akon
Get Buck In Here	DJ Felli Fel Featuring Diddy, Akon, Ludacris & Lil Jon
Freaky Gurl	Gucci Mane
My Drink N' My 2 Step	Cassidy Featuring Swizz Beatz
Roc Boys (And The Winner Is)...	JAY-Z
Blow Ya Mind	Styles P Featuring Swizz Beatz
Fly Like Me	Chingy Featuring Amerie
Baby Don't Go	Fabolous Featuring Jermaine Dupri
Soulja Girl	Soulja Boy Tell'em Featuring I-15
Hood Figga	Gorilla Zoe
Get It Big	Trap Starz Clik
Sensual Seduction	Snoop Dogg
Shawty	Plies Featuring T-Pain
Still Will	50 Cent Featuring Akon
Stronger	Kanye West
I Get Money	50 Cent
Ayo Technology	50 Cent Featuring Justin Timberlake & Timbaland
The Hand Clap	Hurricane Chris Featuring Big Poppa
Make Me Better	Fabolous Featuring Ne-Yo
I Want You	Common
You Know What It Is	T.I. Featuring Wyclef Jean
Blue Magic	JAY-Z
Wadsyaname	Nelly
Can't Tell Me Nothing	Kanye West
Int'l Players Anthem (I Choose You)	UGK Featuring OutKast
A Bay Bay	Hurricane Chris
Money In The Bank	Swizz Beatz
Sexy Lady	Yung Berg Featuring Junior
Big Things Poppin' (Do It)	T.I.
Party Like A Rockstar	Shop Boyz
I Got It From My Mama	will.i.am
Tambourine	Eve
Wipe Me Down	Lil Boosie Featuring Foxx & Webbie
Pop, Lock & Drop It	Huey
Like This	Mims
Coffee Shop	Yung Joc Featuring Gorilla Zoe
Rock Yo Hips	Crime Mob Featuring Lil Scrappy
Lean Like A Cholo	Down A.K.A. Kilo
Tattoo	The Alliance Featuring Fabo
2 Step	Unk
Outta My System	Bow Wow Featuring T-Pain & Johnta Austin
I Tried	Bone Thugs-N-Harmony Featuring Akon
Lil Love	Bone Thugs-N-Harmony Featuring Mariah Carey & Bow Wow
I'm A Flirt	R. Kelly Or Bow Wow (Featuring T.I. & T-Pain)
This Is Why I'm Hot	Mims
We Takin' Over	DJ Khaled Featuring T.I., Akon, Rick Ross, Fat Joe, Lil' Wayne & Baby
Krispy	Kia Shine
Amusement Park	50 Cent
Can U Werk Wit Dat	The Fixxers AKA DJ Quik & AMG
My 64	Mike Jones Featuring Bun B & Snoop Dogg
Lip Gloss	Lil Mama
Push It Baby	Pretty Ricky
It's Me Snitches	Swizz Beatz
Straight To The Bank	50 Cent
Go Getta	Young Jeezy Featuring R. Kelly
Walk It Out	Unk
I'm Throwed	Paul Wall Featuring Jermaine Dupri
Throw Some D's	Rich Boy Featuring Polow Da Don
Make It Rain	Fat Joe Featuring Lil Wayne
Slap	Ludacris
The Way I Live	Baby Boy Da Prince Featuring Lil Boosie
1st Time	Yung Joc Featuring Marques Houston & Trey Songz
We Fly High	Jim Jones
Runaway Love	Ludacris Featuring Mary J. Blige
Top Back	T.I.
Wouldn't Get Far	The Game Featuring Kanye West
Get Buck	Young Buck
Break 'Em Off	Paul Wall Featuring Lil' KeKe
Shortie Like Mine	Bow Wow Featuring Chris Brown & Johnta Austin
Oh Yeah (Work)	Lil Scrappy Featuring Sean P. & E-40
Not A Criminal	Chamillionaire Featuring Kelis
30 Something	JAY-Z
Know What I'm Doin'	Birdman & Lil Wayne Featuring Rick Ross & T-Pain
That's That	Snoop Dogg Featuring R. Kelly
King Kong	Jibbs Featuring Chamillionaire
Come Around	Collie Buddz
Runaway Love	Ludacris Featuring Mary J. Blige
This Is Why I'm Hot	Mims
Throw Some D's	Rich Boy Featuring Polow Da Don
Make It Rain	Fat Joe Featuring Lil Wayne
We Fly High	Jim Jones
Walk It Out	Unk
Go Getta	Young Jeezy Featuring R. Kelly
Top Back	T.I.
I'm A Flirt	R. Kelly Or Bow Wow (Featuring T.I. & T-Pain)
That's That	Snoop Dogg Featuring R. Kelly
Wouldn't Get Far	The Game Featuring Kanye West
2 Step	Unk
Shortie Like Mine	Bow Wow Featuring Chris Brown & Johnta Austin
1st Time	Yung Joc Featuring Marques Houston & Trey Songz
30 Something	JAY-Z
The Way I Live	Baby Boy Da Prince Featuring Lil Boosie
Rock Yo Hips	Crime Mob Featuring Lil Scrappy
Outta My System	Bow Wow Featuring T-Pain & Johnta Austin
King Kong	Jibbs Featuring Chamillionaire
Pop, Lock & Drop It	Huey
Hollywood	Jay Z Featuring Beyonce
Break 'Em Off	Paul Wall Featuring Lil' KeKe
Not A Criminal	Chamillionaire Featuring Kelis
Ay Chico (Lengua Afuera)	Pitbull
It's Me Snitches	Swizz Beatz
I Luv It	Young Jeezy
Money Maker	Ludacris Featuring Pharrell
Zoom	Lil' Boosie Featuring Yung Joc
Lost One	Jay-Z Featuring Chrisette Michele
Money In The Bank	Lil Scrappy Featuring Young Buck
Really Wanna Know You	DJ Clue Featuring Jagged Edge & Fabolous
Stuntin' Like My Daddy	Birdman & Lil Wayne
Let's Ride	The Game
Tell Me	Diddy Featuring Christina Aguilera
Come To Me	Diddy Featuring Nicole Scherzinger
Show Me What You Got	JAY-Z
Rubberband Banks	Young Dro
Dem Jeans	Chingy Featuring Jermaine Dupri
I Know You See It	Yung Joc Featuring Brandy 'Ms. B.' Hambrick
Push It	Rick Ross
Weh Dem A Do	Mavado
Last Night	Diddy Featuring Keyshia Cole
Pullin' Me Back	Chingy Featuring Tyrese
Hip Hop Is Dead	Nas Featuring will.i.am
U And Dat	E-40 Featuring T-Pain & Kandi Girl
It's Okay (One Blood)	The Game Featuring Junior Reid
Shoulder Lean	Young Dro Featuring T.I.
Chain Hang Low	Jibbs
Snap Yo Fingers	Lil Jon Featuring E-40 & Sean Paul Of The YoungBloodZ
(When You Gonna) Give It Up To Me	Sean Paul Featuring Keyshia Cole
Kingdom Come	JAY-Z
It's Goin' Down	Yung Joc
Chicken Noodle Soup.	Webstar & Young B Featuring The Voice Of Harlem
Ghetto Story Chapter 2	Cham Featuring Alicia Keys
Dutty Wine	Tony Matterhorn
Superman	Brown Boy
Peanut Butter & Jelly	Cadillac Don & J-Money
Go To Church	Ice Cube Featuring Snoop Dogg & Lil Jon
Hands Up	Lloyd Banks Featuring 50 Cent
Feels So Good	Remy Ma Featuring Ne-Yo
So What	Field Mob Featuring Ciara
Why You Wanna	T.I.
What You Know	T.I.
In The Ghetto	Busta Rhymes Featuring Rick James
Ridin'	Chamillionaire Featuring Krayzie Bone
Lean Wit It, Rock Wit It	Dem Franchize Boyz Featuring Lil Peanut & Charlay
I Love My B****	Busta Rhymes Featuring will.i.am & Kelis
Vans	The Pack
Hustlin'	Rick Ross
Temperature	Sean Paul
Ms. New Booty	Bubba Sparxxx Featuring Ying Yang Twins & Mr. ColliPark
Gettin' Some	Shawnna
Blow The Whistle	Too $hort
Back Like That	Ghostface Killah Featuring Ne-Yo
Mighty "O"	OutKast
Hmm Hmm	Beenie Man
Holla At Me	DJ Khaled Featuring Lil Wayne, Paul Wall, Fat Joe, Rick Ross & Pitbull
Ridin' Rims	Dem Franchize Boyz
Hustler Musik	Lil Wayne
Heat It Up	Bubba Sparxxx
Girl	Paul Wall
Tell Me When To Go	E-40 Featuring Keak Da Sneak
Best Friend	50 Cent & Olivia
Poppin' My Collar	Three 6 Mafia
Touch It	Busta Rhymes
Conceited (There's Something About Remy)	Remy Ma
Grillz	Nelly Featuring Paul Wall, Ali & Gipp
Rompe	Daddy Yankee
Fresh Azimiz	Bow Wow Featuring J-Kwon & Jermaine Dupri
Get Throwed	Bun-B Featuring Pimp C, Z-Ro, Young Jeezy & Jay-Z
What's Happenin'	Juvenile
Oh Yes (aka 'Postman')	Juelz Santana
Rodeo	Juvenile
Git It	Ying Yang Twins Featuring Bun-B
Bring Out The Freak In You	Lil Rob
Control Myself	LL Cool J Featuring Jennifer Lopez
Betcha Can't Do It Like Me	D4L
Shake That	Eminem Featuring Nate Dogg
Touch The Sky	Kanye West Featuring Lupe Fiasco
Nasty Girl	The Notorious B.I.G. Featuring Diddy, Nelly, Jagged Edge & Avery Storm
My Hood	Young Jeezy
I Think They Like Me	Dem Franchize Boyz Featuring Jermaine Dupri, Da Brat & Bow Wow
Kryptonite (I'm On It)	Purple Ribbon All-Stars
Turn It Up	Chamillionaire Featuring Lil' Flip
Laffy Taffy	D4L
There It Go! (The Whistle Song)	Juelz Santana
Stay Fly	Three 6 Mafia Featuring Young Buck & Eightball & MJG
Georgia	Ludacris & Field Mob Featuring Jamie Foxx
Soul Survivor	Young Jeezy Featuring Akon
Fireman	Lil Wayne
Have A Party	Mobb Deep Featuring 50 Cent & Nate Dogg
Here We Go	Trina Featuring Kelly Rowland
Heard 'Em Say	Kanye West Featuring Adam Levine
Hit The Floor	Twista Featuring Pitbull
Gold Digger	Kanye West Featuring Jamie Foxx
When I'm Gone	Eminem
Girl Tonite	Twista Featuring Trey Songz
We Be Burnin'	Sean Paul
Window Shopper	50 Cent
My Humps	The Black Eyed Peas
Like You	Bow Wow Featuring Ciara
Shake	Ying Yang Twins Featuring Pitbull
Can You Believe It	Styles P Featuring Akon
Lighters Up	Lil' Kim
Can I Have It Like That	Pharrell Featuring Gwen Stefani
Play	David Banner
Presidential	YoungBloodZ
Your Body	Pretty Ricky
Badd	Ying Yang Twins Featuring Mike Jones & Mr. ColliPark
Outta Control (Remix)	50 Cent Featuring Mobb Deep
I'm A King	P$C Featuring T.I. & Lil Scrappy
Let Me Hold You	Bow Wow Featuring Omarion
Lose Control	Missy Elliott Featuring Ciara & Fat Man Scoop
Go Crazy	Young Jeezy Featuring Jay-Z
Pimpin' All Over The World	Ludacris Featuring Bobby Valentino
Welcome To Jamrock	Damian "Jr. Gong" Marley
Pon de Replay	Rihanna
And Then What	Young Jeezy Featuring Mannie Fresh
Back Then	Mike Jones
So Seductive	Tony Yayo Featuring 50 Cent
Grind With Me	Pretty Ricky
Just A Lil Bit	50 Cent
Gotta Getcha	Jermaine Dupri
Give Me That	Webbie Featuring Bun B
Summer Nights	Lil Rob
Footprints	T.O.K.
Dem Boyz	Boyz N Da Hood
Sittin' Sidewayz	Paul Wall Featuring Big Pokey
Get It Poppin'	Fat Joe Featuring Nelly
Dreams	The Game
